{
    "map":[
        [0,0,0,0,0,4],
        [0,4,0,0,0,0],
        [0,4,0,0,0,0],
        [0,0,0,0,4,0],
        [0,0,0,0,4,0],
        [0,4,0,0,0,0],
        [0,4,0,0,0,0],
        [0,0,0,0,4,0],
        [0,0,0,0,4,0],
        [4,0,0,0,0,0]
    ],
    "startPoint": [3,0],
    "startDirection": "DOWN"
}
