{
    "map":[
        [4,0,0,0,0,4,0,0,0,0,0,0,4],
        [0,0,0,0,0,4,0,0,0,0,0,0,0],
        [0,0,6,0,0,0,4,0,0,0,0,0,0],
        [0,0,0,0,0,0,4,0,0,0,6,0,0],
        [0,0,0,0,0,0,0,4,0,0,0,0,0],
        [4,0,0,0,0,0,0,4,0,0,0,0,4]
    ],
    "startPoint": [8,5],
    "startDirection": "UP",
    "portal": [[2,2],[10,3]]
}
